NO ./textures/red.xpm
SO ./textures/blue.xpm
WE ./textures/green.xpm
EA ./textures/violet.xpm
F 119,119,119
C 51,51,51
1111111111111111111111111
1000000001100000000000011
1000000001110000000000001
111100000000000000000000111111111
101111111011000001110000000000001
100000000011000001110111111111111
10111110000000000000001111111111
10110111111111011100000010001
10010111111111011101001000001
10000000110101011100000000001
1000000000000000000010N010001
10000000000000000000000000001
10000001110101011110001000001
10110111 1110101 100000000001
11111111 1111111 111111111111
